####################
#A#   ##   #      B #
# # # #  # #  # #   #
# # # ##    # #  # # #
# #   ## #  # # ##   #
# # #   ## # ##  ##  #
# # # # ###      ## # 
# # #   ##  # #   #  #
# #    ##   ## # ##  #
# # ## # ##  #    #  #
# #  # # #  ### ## # #
# #    ##  ##    #   #
# # #   ##   ## # ## #
# #  #     # #   # # #
# ## #  ## # ## # #  #
#    #  #    #  #    #
####################
